# Simple map pour cub3D
NO ./textures/north.xpm
SO ./textures/south.xpm
WE ./textures/west.xpm
EA ./textures/east.xpm
F 220,100,0
C 135,206,235

1111111111111
1000000000001
1011110111101
1000000000001
1000000N00001
1011111111101
1000000000001
1111111111111
